1111111111111111111111111111111111
101000000000001C10001C100000000001
1010010100100000101001000000010101
1010010010101010001001000000010101
1P0000000C01C1000000000000000000C1
1111111111111111111111111111111111