1111111111111111111111111111111111
100000000000111100000E000000000111
10000C000000100000000P000000000001
100000000C0010C0000001111000000001
1000000000000000000001C01000000001
1111111111111111111111111111111111