1111111111111111111111111111111111
100000000000111100000E0000000001P1
10000C0000001000000000000000000011
100000000C0010C0000001111000000001
100000000000000000000C0C1000000001
1111111111111111111111111111111111